00 00 00 00 00 00 00 00 00 00
00 05 03 03 03 03 03 03 06 00
00 01 09 09 09 09 09 09 02 00
00 01 09 09 09 09 09 09 02 00
00 01 09 09 09 09 09 09 02 00
00 01 09 09 09 09 09 09 02 00
00 01 09 09 09 09 09 09 02 00
00 01 09 09 09 09 09 09 02 00
00 07 04 04 04 04 04 04 08 00
00 00 00 00 00 00 00 00 00 00
