04 31 31 31 31 31 31 31 31 05 21 00 00 00 00 00 00 00 00 00 00 00 00 00 00 00 00 00 00 00
22 60 61 61 61 61 61 61 62 20 21 00 00 00 00 00 00 00 00 00 00 00 00 00 00 00 00 00 00 00
22 70 71 71 71 71 71 71 72 20 21 21 21 21 21 21 21 21 21 00 00 00 00 00 00 00 00 00 00 00
22 70 71 71 71 71 71 71 72 30 31 31 31 31 31 31 31 05 21 00 00 00 00 00 00 00 00 00 00 00
22 70 71 71 71 71 71 71 74 61 61 61 61 61 61 61 62 20 21 00 00 00 00 00 00 00 00 00 00 00
22 70 71 71 71 71 71 71 71 71 71 71 71 71 71 71 72 20 21 00 00 00 00 00 00 00 00 00 00 00
22 70 71 71 71 71 71 71 64 81 81 81 81 81 81 81 82 20 21 00 00 00 00 00 00 00 00 00 00 00
22 70 71 71 71 71 71 71 72 10 11 11 11 11 11 11 11 15 21 00 00 00 00 00 00 00 00 00 00 00
22 70 71 71 71 71 71 71 72 20 21 21 21 21 21 21 21 21 21 00 00 00 00 00 00 00 00 00 00 00
22 70 71 71 71 71 71 71 72 20 21 00 00 00 00 00 00 00 00 00 00 00 00 00 00 00 00 00 00 00
22 80 81 81 81 81 81 81 82 20 21 00 00 00 00 00 00 00 00 00 00 00 00 00 00 00 00 00 00 00
14 11 11 11 11 11 11 11 11 15 21 00 00 00 00 00 00 00 00 00 00 00 00 00 00 00 00 00 00 00
21 21 21 21 21 21 21 21 21 21 21 00 00 00 00 00 00 00 00 00 00 00 00 00 00 00 00 00 00 00
00 00 00 00 00 00 00 00 00 00 00 00 00 00 00 00 00 00 00 00 00 00 00 00 00 00 00 00 00 00
00 00 00 00 00 00 00 00 00 00 00 00 00 00 00 00 00 00 00 00 00 00 00 00 00 00 00 00 00 00
00 00 00 00 00 00 00 00 00 00 00 00 00 00 00 00 00 00 00 00 00 00 00 00 00 00 00 00 00 00
00 00 00 00 00 00 00 00 00 00 00 00 00 00 00 00 00 00 00 00 00 00 00 00 00 00 00 00 00 00
00 00 00 00 00 00 00 00 00 00 00 00 00 00 00 00 00 00 00 00 00 00 00 00 00 00 00 00 00 00
00 00 00 00 00 00 00 00 00 00 00 00 00 00 00 00 00 00 00 00 00 00 00 00 00 00 00 00 00 00
00 00 00 00 00 00 00 00 00 00 00 00 00 00 00 00 00 00 00 00 00 00 00 00 00 00 00 00 00 00
00 00 00 00 00 00 00 00 00 00 00 00 00 00 00 00 00 00 00 00 00 00 00 00 00 00 00 00 00 00
00 00 00 00 00 00 00 00 00 00 00 00 00 00 00 00 00 00 00 00 00 00 00 00 00 00 00 00 00 00
00 00 00 00 00 00 00 00 00 00 00 00 00 00 00 00 00 00 00 00 00 00 00 00 00 00 00 00 00 00
00 00 00 00 00 00 00 00 00 00 00 00 00 00 00 00 00 00 00 00 00 00 00 00 00 00 00 00 00 00
00 00 00 00 00 00 00 00 00 00 00 00 00 00 00 00 00 00 00 00 00 00 00 00 00 00 00 00 00 00
00 00 00 00 00 00 00 00 00 00 00 00 00 00 00 00 00 00 00 00 00 00 00 00 00 00 00 00 00 00
00 00 00 00 00 00 00 00 00 00 00 00 00 00 00 00 00 00 00 00 00 00 00 00 00 00 00 00 00 00
00 00 00 00 00 00 00 00 00 00 00 00 00 00 00 00 00 00 00 00 00 00 00 00 00 00 00 00 00 00
00 00 00 00 00 00 00 00 00 00 00 00 00 00 00 00 00 00 00 00 00 00 00 00 00 00 00 00 00 00
00 00 00 00 00 00 00 00 00 00 00 00 00 00 00 00 00 00 00 00 00 00 00 00 00 00 00 00 00 00
