04 31 31 31 31 31 31 31 31 05 21 21 21 21 21 21 21 21 21 21 21 21 21 21 21 21 21 21 21 21
22 60 61 61 61 61 61 61 62 20 21 21 21 21 21 21 21 21 21 21 21 21 21 21 21 21 21 21 21 21
22 70 71 71 71 71 71 71 72 20 21 21 21 21 21 21 21 21 21 21 21 21 21 21 21 21 21 21 21 21
22 70 71 71 71 71 71 71 72 30 31 31 31 31 31 31 31 05 21 21 21 21 21 21 21 21 21 21 21 21
22 70 71 71 71 71 71 71 74 61 61 61 61 61 61 61 62 20 21 21 21 21 21 21 21 21 21 21 21 21
22 70 71 71 71 71 71 71 71 71 71 71 71 71 71 71 72 20 21 21 21 21 21 21 21 21 21 21 21 21
22 70 71 71 71 71 71 71 64 81 81 81 81 81 65 71 72 20 21 21 21 21 21 21 21 21 21 21 21 21
22 70 71 71 71 71 71 71 72 10 11 11 11 12 70 71 72 30 31 31 31 31 31 31 31 31 31 31 31 05
22 70 71 71 71 71 71 71 72 20 21 21 21 22 70 71 74 61 61 61 61 61 61 61 61 61 61 61 62 20
22 70 71 71 71 71 71 71 72 20 21 21 21 22 70 71 71 71 71 71 71 71 71 71 71 71 71 71 72 20
22 80 81 81 81 81 81 81 82 20 21 21 21 22 70 71 64 81 81 81 65 71 64 81 81 81 65 71 72 20
14 11 11 11 11 11 11 11 11 15 21 21 21 22 70 71 72 28 42 43 70 71 72 41 42 29 70 71 72 20
21 21 21 21 21 21 21 21 21 21 21 21 21 22 70 71 72 13 60 61 75 71 74 61 62 13 70 71 72 20
21 21 21 21 21 21 21 21 21 21 21 21 21 22 70 71 72 13 70 71 71 71 71 71 72 13 70 71 72 20
21 21 21 21 21 21 21 21 21 21 21 21 21 22 70 71 72 13 80 81 81 81 81 81 82 13 70 71 72 20
21 21 21 04 31 31 31 31 31 31 31 31 31 32 70 71 72 38 42 42 42 42 42 42 42 39 70 71 72 20
21 21 04 32 60 61 61 61 61 61 61 61 61 61 75 71 74 61 61 61 61 61 61 61 61 61 75 71 72 20
21 04 32 60 75 71 71 71 71 71 71 71 71 71 71 71 71 71 71 71 71 71 71 71 71 71 71 71 72 20
04 32 60 75 64 81 81 81 65 71 64 81 81 81 65 71 64 81 81 81 81 65 71 64 81 81 81 81 82 20
22 60 75 71 72 10 11 12 70 71 72 10 11 12 70 71 72 10 11 11 12 70 71 72 10 11 11 11 11 15
22 70 71 71 72 20 21 22 70 71 72 20 21 22 70 71 72 20 04 05 22 70 71 72 20 21 21 21 21 21
22 70 71 71 72 20 21 22 70 71 72 20 21 22 70 71 72 20 14 15 22 70 71 72 20 21 21 21 21 21
22 80 71 71 72 30 31 32 70 71 72 30 31 32 70 71 72 30 31 31 32 70 71 72 20 21 21 21 21 21
14 12 80 71 74 61 61 61 75 71 74 61 61 61 75 71 74 61 61 61 61 75 71 72 20 21 21 21 21 21
21 14 12 80 71 71 71 71 71 71 71 71 71 71 71 71 71 71 71 71 71 71 71 72 20 21 21 21 21 21
21 21 14 12 80 81 81 81 81 81 81 81 81 81 81 81 81 81 81 81 81 81 81 82 20 21 21 21 21 21
21 21 21 14 11 11 11 11 11 11 11 11 11 11 11 11 11 11 11 11 11 11 11 11 15 21 21 21 21 21
21 21 21 21 21 21 21 21 21 21 21 21 21 21 21 21 21 21 21 21 21 21 21 21 21 21 21 21 21 21
21 21 21 21 21 21 21 21 21 21 21 21 21 21 21 21 21 21 21 21 21 21 21 21 21 21 21 21 21 21
21 21 21 21 21 21 21 21 21 21 21 21 21 21 21 21 21 21 21 21 21 21 21 21 21 21 21 21 21 21
